9 9 9 9 9 9 9 9 9 9 9 9 9 9 9 9 9 9 9 9 9 9 9 9 9 9 9 9 9 9 6 6 9 9 9 9 9 9 9 9 9 9 9 9 9 9 9 9 9 9 9 9 9 9 9 9 9 9 9 9 9 9 9 9 9 9 9 9 9 9 9 9 9 9 9 9 6 6 9 9 9 9 9 9 9 9 9 9 9 9 9 9 9 9 9 9 9 9 9 9 9 9 9 9 9 9 9 9 9 9 9 9 9 9 9 9 9 9 9 9 9 9 9 9 9 9 9 9 9 9 9 9
9 9 9 9 9 9 9 9 9 9 9 9 9 9 9 9 9 9 9 9 9 9 9 9 9 9 9 9 9 9 6 6 9 9 9 9 9 9 9 9 9 9 9 9 9 9 9 9 9 9 9 9 9 9 9 9 9 9 9 9 9 9 9 9 9 9 9 9 9 9 9 9 9 9 9 9 6 6 9 9 9 9 9 9 9 9 9 9 9 9 9 9 9 9 9 9 9 9 9 9 9 9 9 9 9 9 9 9 9 9 9 9 9 9 9 9 9 9 9 9 9 9 9 9 9 9 9 9 9 9 9 9
9 9 9 9 9 9 9 9 9 9 9 9 9 9 9 9 9 9 9 9 9 9 9 9 9 9 9 9 9 9 6 6 9 9 9 9 9 9 9 9 9 9 9 9 9 9 9 9 9 9 9 9 9 9 9 9 9 9 9 9 9 9 9 9 9 9 9 9 9 9 9 9 9 9 9 9 6 6 9 9 9 9 9 9 9 9 9 9 9 9 9 9 9 9 9 9 9 9 9 9 9 9 9 9 9 9 9 9 9 9 9 9 9 9 9 9 9 9 9 9 9 9 9 9 9 9 9 9 9 9 9 9
9 9 9 9 9 9 9 9 9 9 9 9 9 9 9 9 9 9 9 9 9 9 9 9 9 9 9 9 9 9 6 6 9 9 9 9 9 9 9 9 9 9 9 9 9 9 9 9 9 9 9 9 9 9 9 9 9 9 9 9 9 9 9 9 9 9 9 9 9 9 9 9 9 9 9 9 6 6 9 9 9 9 9 9 9 9 9 9 9 9 9 9 9 9 9 9 9 9 9 9 9 9 9 9 9 9 9 9 9 9 9 9 9 9 9 9 9 9 9 9 9 9 9 9 9 9 9 9 9 9 9 9
9 9 9 9 9 9 9 9 9 9 9 9 9 9 9 9 9 9 9 9 9 9 9 9 9 9 9 9 9 9 6 6 9 9 9 9 9 9 9 9 9 9 9 9 9 9 9 9 9 9 9 9 9 9 9 9 9 9 9 9 9 9 9 9 9 9 9 9 9 9 9 9 9 9 9 9 6 6 9 9 9 9 9 9 9 9 9 9 9 9 9 9 9 9 9 9 9 9 9 9 9 9 9 9 9 9 9 9 9 9 9 9 9 9 9 9 9 9 9 9 9 9 9 9 9 9 9 9 9 9 9 9
9 9 9 9 9 9 9 9 9 9 9 9 9 9 9 9 9 9 9 9 9 9 9 9 9 9 9 9 9 9 6 6 9 9 9 9 9 9 9 9 9 9 9 9 9 9 9 9 9 9 9 9 9 9 9 9 9 9 9 9 9 9 9 9 9 9 9 9 9 9 9 9 9 9 9 9 6 6 9 9 9 9 9 9 9 9 9 9 9 9 9 9 9 9 9 9 9 9 9 9 9 9 9 9 9 9 9 9 9 9 9 9 9 9 9 9 9 9 9 9 9 9 9 9 9 9 9 9 9 9 9 9
9 9 9 9 9 9 9 9 9 9 9 9 9 9 9 9 9 9 9 9 9 9 9 9 9 9 9 9 9 9 6 6 9 9 9 9 9 9 9 9 9 9 9 9 9 9 9 9 9 9 9 9 9 9 9 9 9 9 9 9 9 9 9 9 9 9 9 9 9 9 9 9 9 9 9 9 6 6 9 9 9 9 9 9 9 9 9 9 9 9 9 9 9 9 9 9 9 9 9 9 9 9 9 9 9 9 9 9 9 9 9 9 9 9 9 9 9 9 9 9 9 9 9 9 9 9 9 9 9 9 9 9
9 9 9 9 9 9 9 9 9 9 9 9 9 9 9 9 9 9 9 9 9 9 9 9 9 9 9 9 9 9 6 6 9 9 9 9 9 9 9 9 9 9 9 9 9 9 9 9 9 9 9 9 9 9 9 9 9 9 9 9 9 9 9 9 9 9 9 9 9 9 9 9 9 9 9 9 6 6 9 9 9 9 9 9 9 9 9 9 9 9 9 9 9 9 9 9 9 9 9 9 9 9 9 9 9 9 9 9 9 9 9 9 9 9 9 9 9 9 9 9 9 9 9 9 9 9 9 9 9 9 9 9
9 9 9 9 9 9 9 9 f f f f f f f f f f f f f f f f f f f f f f 6 6 4 4 4 4 4 4 4 4 4 4 4 4 4 4 4 4 4 4 4 4 4 4 4 4 4 4 4 4 4 4 4 4 4 4 4 4 4 4 4 4 4 4 4 4 6 6 4 4 4 4 4 4 4 4 4 4 b 4 4 4 b 4 4 4 4 4 4 4 4 4 4 b 4 4 4 4 4 4 4 4 4 4 b 4 4 4 4 4 4 4 4 4 9 9 9 9 9 9 9 9
9 9 9 9 9 9 9 9 f f f f f f f f f f f f f f f f f f f f f f 6 6 4 4 4 4 4 4 4 4 4 4 4 4 4 4 4 4 4 4 4 4 4 4 4 4 4 4 4 4 4 4 4 4 4 4 4 4 4 4 4 4 4 4 4 4 6 6 4 a 4 a 4 4 4 b 4 4 4 4 4 4 4 4 4 4 a 4 b 4 4 b 4 4 4 4 a 4 4 4 b 4 4 4 4 4 4 4 a 4 4 a 4 b 9 9 9 9 9 9 9 9
9 9 9 9 9 9 9 9 f f f f f f f f f f f f f f f f f f f f f f 6 6 4 4 4 4 4 4 4 4 4 4 4 4 4 4 4 4 4 4 4 4 4 4 4 4 4 4 4 4 4 4 4 4 4 4 4 4 4 4 4 4 4 4 4 4 4 6 6 4 4 4 4 a 4 4 4 a 4 4 a 4 4 4 4 4 4 4 4 4 4 4 4 4 4 4 4 4 4 4 4 4 a 4 4 4 4 4 4 4 4 4 4 4 9 9 9 9 9 9 9 9
9 9 9 9 9 9 9 9 f f f f f f f f f f f f f f f f f f f f f f 6 6 4 4 4 4 4 4 4 4 4 4 4 4 4 4 4 4 4 4 4 4 4 4 4 4 4 4 4 4 4 4 4 4 4 4 4 4 4 4 4 4 4 4 4 4 4 6 6 4 b 4 4 4 4 4 4 4 4 4 4 4 b 4 4 4 b 4 4 a 4 b 4 4 4 4 4 4 4 a 4 4 4 4 b 4 4 4 b 4 4 a 4 b 9 9 9 9 9 9 9 9
9 9 9 9 9 9 9 9 f f f f f f f f f f f f f f f f f f f f f f 6 6 6 4 4 4 4 4 4 4 4 4 4 4 4 4 4 4 4 4 4 4 4 4 4 4 4 4 4 4 4 4 4 4 4 4 4 4 4 4 4 4 4 4 4 4 4 4 5 5 4 4 b 4 4 4 4 b 4 4 4 4 4 4 a 4 4 4 4 4 4 4 4 4 4 4 b 4 4 4 4 4 4 4 4 4 4 4 4 4 4 4 4 4 9 9 9 9 9 9 9 9
9 9 9 9 9 9 9 9 f f f f f f f f f f f f f f f f f f f f f f f 6 6 4 4 4 4 4 4 4 4 4 4 4 4 4 4 4 4 4 4 4 4 4 4 4 4 4 4 4 4 4 4 4 4 4 4 4 4 4 4 4 4 4 4 4 4 4 5 5 4 4 4 4 4 b 4 4 4 a 4 4 4 4 4 4 4 4 a 4 4 4 4 b 4 4 4 4 4 4 4 a 4 4 4 4 4 4 4 a 4 4 4 b 9 9 9 9 9 9 9 9
9 9 9 9 9 9 9 9 f f f f f f f f f f f f f f f f f f f f f f f 6 6 6 4 4 4 4 4 4 4 4 4 4 4 4 4 4 4 4 4 4 4 4 4 4 4 4 4 4 4 4 4 4 4 4 4 4 4 4 4 4 4 4 4 4 4 4 6 6 4 4 b 4 4 4 4 4 4 4 4 4 4 a 4 4 4 4 4 4 4 4 4 4 4 4 4 4 4 4 4 4 4 4 4 a 4 4 4 4 4 4 4 4 9 9 9 9 9 9 9 9
9 9 9 9 9 9 9 9 f f f f f f f f f f f f f f f f f f f f f f f 6 6 6 6 4 4 4 4 4 4 4 4 4 4 4 4 4 4 4 4 4 4 4 4 4 4 4 4 4 4 4 4 4 4 4 4 4 4 4 4 4 4 4 4 4 4 4 4 6 6 4 4 4 a 4 4 a 4 4 b 4 4 4 4 b 4 4 a 4 4 a 4 4 b 4 a 4 4 b 4 4 4 4 4 4 4 4 4 4 a 4 4 a 9 9 9 9 9 9 9 9
9 9 9 9 9 9 9 9 f f f f f f f f f f f f f f f f f f f f f f f f 6 6 6 4 4 4 4 4 4 4 4 4 4 4 4 4 4 4 4 4 4 4 4 4 4 4 4 4 4 4 4 4 4 4 4 4 4 4 4 4 4 4 4 4 4 4 4 6 6 4 a 4 4 4 4 4 4 4 4 4 4 a 4 4 4 4 4 4 4 4 4 4 4 4 4 4 4 4 4 4 4 4 4 a 4 4 4 4 4 4 4 4 9 9 9 9 9 9 9 9
9 9 9 9 9 9 9 9 f f f f f f f f f f f f f f f f f f f f f f f f f 6 6 6 6 4 4 4 4 4 4 4 4 4 4 4 4 4 4 4 4 4 4 4 4 4 4 4 4 4 4 4 4 4 4 4 4 4 4 4 4 4 4 4 4 4 4 6 6 6 4 4 b 6 6 6 6 6 6 6 6 6 6 6 6 6 6 6 6 6 4 4 4 4 b 4 4 b 4 4 b 4 4 4 4 b 4 4 a 4 4 4 9 9 9 9 9 9 9 9
9 9 9 9 9 9 9 9 f f f f f f f f f f f f f f f f f f f f f f f f f f 6 6 6 4 4 4 4 4 4 4 4 4 4 4 4 4 4 4 4 4 4 4 4 4 4 4 4 4 4 4 4 4 4 4 4 4 4 4 4 4 4 4 4 4 4 4 6 6 4 6 6 6 6 6 6 6 6 6 6 6 6 6 6 6 6 6 6 6 6 6 6 6 4 4 4 4 4 4 4 4 4 4 4 4 4 4 4 4 4 4 9 9 9 9 9 9 9 9
9 9 9 9 9 9 9 9 f f f f f f f f f f f f f f f f f f f f f f f f f f f 6 6 6 4 4 4 4 4 4 4 4 4 4 4 4 4 4 4 4 4 4 4 4 4 4 4 4 4 4 4 4 4 4 4 4 4 4 4 4 4 4 4 4 4 4 6 6 6 6 6 6 6 6 6 6 6 6 6 6 6 6 6 6 6 6 6 6 6 6 6 6 6 4 4 4 a 4 4 b 4 4 a 4 4 b 4 4 4 4 9 9 9 9 9 9 9 9
9 9 9 9 9 9 9 9 f f f f f f f f f f f f f f f f f f f f f f f f f f f f 6 6 6 4 4 4 4 4 4 4 4 4 4 4 4 4 4 4 4 4 4 4 4 4 4 4 4 4 4 4 4 4 4 4 4 4 4 4 4 4 4 4 4 6 6 6 6 6 6 6 6 6 6 6 6 6 6 6 6 6 6 6 6 6 6 6 6 6 6 6 6 6 4 4 4 4 4 4 4 4 4 4 4 4 4 4 b 4 9 9 9 9 9 9 9 9
9 9 9 9 9 9 9 9 f f f f f f f f f f f f f f f f f f f f f f f f f f f f f 6 6 6 4 4 4 4 4 4 4 4 4 4 4 4 4 4 4 4 4 4 4 4 4 4 4 4 4 4 4 4 4 4 4 4 4 4 4 4 4 4 4 6 6 6 6 6 6 6 6 6 6 6 6 6 6 6 6 6 6 6 6 6 6 6 6 6 6 6 6 6 6 4 4 4 4 b 4 4 4 4 4 a 4 4 4 4 9 9 9 9 9 9 9 9
9 9 9 9 9 9 9 9 f f f f f f f f f f f f f f f f f f f f f f f f f f f f f f 6 6 6 4 4 4 4 4 4 4 4 4 4 4 4 4 4 4 4 4 4 4 4 4 4 4 4 4 4 4 4 4 4 4 4 4 4 4 4 4 6 6 6 6 6 6 6 6 6 6 6 6 6 6 6 6 6 6 6 6 6 6 6 6 6 6 6 6 6 6 6 4 a 4 4 4 4 4 4 4 4 4 4 4 4 4 9 9 9 9 9 9 9 9
9 9 9 9 9 9 9 9 f f f f f f f f f f f f f f f f f f f f f f f f f f f f f f f 6 6 4 4 4 4 4 4 4 4 4 4 4 4 4 4 4 4 4 4 4 4 4 4 4 4 4 4 4 4 4 4 4 4 4 4 4 4 4 6 6 6 6 6 6 6 6 6 6 6 6 6 6 6 6 6 6 6 6 6 6 6 6 6 6 6 6 6 6 6 6 4 4 4 4 a 4 4 b 4 4 a 4 4 4 9 9 9 9 9 9 9 9
9 9 9 9 9 9 9 9 f f f f f f f f f f f f f f f f f f f f f f f f f f f f f f f 6 6 4 4 4 4 4 4 4 4 4 4 4 4 4 4 4 4 4 4 4 4 4 4 4 4 4 4 4 4 4 4 4 4 4 4 4 4 4 6 6 6 6 6 6 6 6 6 6 6 e e e e e e e e e e 6 6 6 6 6 6 6 6 6 6 6 4 4 4 4 4 4 4 4 4 4 b 4 4 4 9 9 9 9 9 9 9 9
9 9 9 9 9 9 9 9 f f f f f f f f f f f f f f f f f f f f f f f f f f f f f f f 6 6 4 4 4 4 4 4 4 4 4 4 4 4 4 4 4 4 4 4 4 4 4 4 4 4 4 4 4 4 4 4 4 4 4 4 4 4 4 6 6 6 6 6 6 6 6 6 6 6 e 3 3 3 3 8 c d 7 e 6 6 6 6 6 6 6 6 6 6 6 4 b 4 4 b 4 4 4 4 4 4 4 a 4 9 9 9 9 9 9 9 9
9 9 9 9 9 9 9 9 f f f f f f f f f f f f f f f f f f f f f f f f f f f f f f f 6 6 6 4 4 4 4 4 4 4 4 4 4 4 4 4 4 4 4 4 4 4 4 4 4 4 4 4 4 4 4 4 4 4 4 4 4 4 6 6 6 6 6 6 6 6 6 6 6 6 e 3 3 3 3 3 3 3 3 e 6 6 6 6 6 6 6 6 6 6 6 4 4 a 4 4 4 4 4 a 4 4 4 4 4 9 9 9 9 9 9 9 9
9 9 9 9 9 9 9 9 f f f f f f f f f f f f f f f f f f f f f f f f f f f f f f f f 6 6 6 6 6 6 6 6 6 4 4 4 4 4 4 4 4 4 4 4 4 4 4 4 4 4 4 4 4 4 4 4 4 4 4 4 4 6 6 6 6 6 6 6 6 6 6 6 6 e 3 3 3 3 3 3 3 3 e 6 6 6 6 6 6 6 6 6 6 6 4 4 4 4 4 4 b 4 4 4 4 4 4 4 9 9 9 9 9 9 9 9
9 9 9 9 9 9 9 9 f f f f f f f f f f f f f f f f f f f f f f f f f f f f f f f f 6 6 6 6 6 6 6 6 6 6 4 4 4 4 4 4 4 4 4 4 4 4 4 4 4 4 4 4 4 4 4 4 4 4 4 4 4 6 6 6 6 6 6 6 6 6 6 6 6 e 3 3 3 3 3 3 3 3 e 6 6 6 6 6 6 6 6 6 6 6 4 4 4 4 a 4 4 4 4 4 4 4 a 4 9 9 9 9 9 9 9 9
9 9 9 9 9 9 9 9 f f f f f f f f f f f f f f f f f f f f f f f f f f f f f f f f 6 6 6 6 6 4 a 4 4 6 6 6 6 6 6 6 4 4 4 4 4 4 4 4 4 4 4 4 4 4 4 4 4 4 4 4 4 6 6 6 6 6 6 6 6 6 6 6 6 e 3 3 3 3 3 3 3 3 e 6 6 6 6 6 6 6 6 6 6 6 4 4 4 4 4 4 4 a 4 4 b 4 4 4 9 9 9 9 9 9 9 9
9 9 9 9 9 9 9 9 f f f f f f f f f f f f f f f f f f f f f f f f f f f f f f f 6 6 6 6 6 9 9 4 4 4 4 6 6 6 6 6 6 6 6 5 5 6 6 6 6 6 6 6 6 6 6 6 6 6 6 6 6 6 6 6 6 6 6 6 6 6 6 6 6 6 e 3 3 3 3 3 3 3 3 e 6 6 6 6 6 6 6 6 6 6 6 4 a 4 4 4 a 4 4 4 4 a 4 b 4 9 9 9 9 9 9 9 9
9 9 9 9 9 9 9 9 f f f f f f f f f f f f f f f f f f f f f f f f f f f f f f f 6 6 6 6 9 9 9 4 4 b 4 4 4 4 a 4 4 6 6 5 5 6 6 6 6 6 6 6 6 6 6 6 6 6 6 6 6 6 6 6 6 6 6 6 6 6 6 6 6 6 e e e e e e e e e e 6 6 6 6 6 6 6 6 6 6 6 4 4 4 4 4 4 4 4 4 4 4 4 4 4 9 9 9 9 9 9 9 9
9 9 9 9 9 9 9 9 f f f f f f f f f f f f f f f f f f f f f f f f f f f f f f 6 6 6 6 9 9 9 9 4 4 4 4 4 4 4 4 4 4 4 4 2 2 4 4 4 4 4 4 4 4 a 4 4 4 4 4 4 4 4 6 6 6 6 6 6 6 6 6 6 6 6 6 6 6 6 5 5 6 6 6 6 6 6 6 6 6 6 6 6 6 6 6 4 4 4 b 4 a 4 4 4 b 4 4 4 9 9 9 9 9 9 9 9 9
9 9 9 9 9 9 9 9 f f f f f f f f f f f f f f f f f f f f f f f f f f f f 6 6 6 6 6 9 9 9 9 9 4 4 4 4 4 a 4 4 b 4 4 4 2 2 4 4 b 4 4 4 4 4 4 4 4 4 4 4 4 b 4 6 6 6 6 6 6 6 6 6 6 6 6 6 6 6 6 5 5 6 6 6 6 6 6 6 6 6 6 6 6 6 6 6 4 4 4 4 4 4 4 4 4 4 b 4 9 9 9 9 9 9 9 9 9 9
9 9 9 9 9 9 9 9 f f f f f f f f f f f f f f f f f f f f f f f f f f f f 6 6 4 9 9 9 9 9 9 9 4 a 4 4 4 4 4 4 4 4 4 4 2 2 4 4 4 4 4 a 4 4 4 4 4 4 4 a 4 4 4 4 6 6 6 6 6 6 6 6 6 6 6 6 6 6 6 5 5 6 6 6 6 6 6 6 6 6 6 6 6 6 6 6 4 4 a 4 4 4 4 4 a 4 4 9 9 9 9 9 9 9 9 9 9 9
9 9 9 9 9 9 9 9 f f f f f f f f f f f f f f f f f f f f f f f f f f f 6 6 4 4 9 9 9 9 9 k k k k k k k k k k k k 4 b 2 2 4 4 4 4 4 4 4 4 4 a 4 4 4 4 4 4 4 4 4 6 6 6 6 6 6 6 6 6 6 6 6 6 6 5 5 6 6 6 6 6 6 6 6 6 6 6 6 6 6 6 4 4 4 4 4 b 4 4 4 4 9 9 9 9 9 9 9 9 9 9 9 9
9 9 9 9 9 9 9 9 f f f f f f f f f f f f f f f f f f f f f f f f f f f 5 5 4 4 9 9 9 9 9 k j j j j j j j j j j k 4 4 2 2 4 4 a 4 4 4 4 4 4 4 4 4 4 4 4 b 4 4 4 4 6 6 6 6 6 6 6 6 6 6 6 6 6 5 5 6 6 6 6 6 6 6 6 6 6 6 6 6 6 4 4 4 4 4 4 4 4 4 4 4 9 9 9 9 9 9 9 9 9 9 9 9
9 9 9 9 9 9 9 9 f f f f f f f f f f f f f f f f f f f f f f f f f f f 5 5 4 4 9 9 9 9 9 k j j j j j j j j j j k 4 4 2 2 4 4 4 4 4 b 4 4 4 a 4 4 4 4 4 4 4 4 b 4 6 6 6 6 6 6 6 6 6 6 6 6 6 5 5 6 6 6 6 6 6 6 6 6 6 6 6 6 6 4 4 b 4 4 4 4 4 4 4 9 9 9 9 9 9 9 9 9 9 9 9 9
9 9 9 9 9 9 9 9 f f f f f f f f f f f f f f f f f f f f f f f f f f f 6 6 4 4 9 9 9 9 9 k j j j j j j j j j j 2 2 2 2 2 4 4 4 4 4 4 4 4 4 4 4 4 4 4 4 4 4 4 4 4 4 6 6 6 6 6 6 6 6 6 6 6 6 5 5 6 6 6 6 6 6 6 6 6 6 6 6 6 6 4 4 4 4 a 4 4 b 4 9 9 9 9 9 9 9 9 9 9 9 9 9 9
9 9 9 9 9 9 9 9 f f f f f f f f f f f f f f f f f f f f f f 6 6 6 6 6 6 6 4 4 9 9 9 9 9 k j j j j j j j j j j k 4 4 2 2 4 a 4 4 4 4 4 a 4 4 4 4 b 4 4 a 4 4 4 a 4 4 4 6 6 6 6 6 6 6 6 6 6 5 5 6 6 6 6 6 6 6 6 6 6 6 6 6 4 4 b 4 4 4 4 4 4 9 9 9 9 9 9 9 9 9 9 9 9 9 9 9
9 9 9 9 9 9 9 9 f f f f f f f f f f f f f f f f f f 6 6 6 6 6 6 6 6 6 6 6 6 4 9 9 9 9 9 k j j j j j j j j j j k 4 4 2 2 4 4 4 4 a 4 4 4 4 4 4 4 4 4 4 4 4 4 b 4 4 a 4 4 4 4 4 4 b 4 4 4 4 2 2 4 4 4 4 4 4 4 4 4 4 4 4 4 4 4 4 4 4 4 4 4 9 9 9 9 9 9 9 9 9 9 9 9 9 9 9 9
9 9 9 9 9 9 9 9 f f f f f f f f f f f f f f f f f 6 6 6 6 6 4 4 4 4 4 4 6 6 6 9 9 9 9 9 k j j j j j j j j j j k b 4 2 2 4 4 4 4 4 4 4 4 4 4 a 4 4 4 a 4 4 4 4 4 4 4 4 4 4 4 a 4 4 b 4 4 4 2 2 4 4 4 a 4 4 4 a 4 4 b 4 a 4 4 4 4 4 4 b 9 9 9 9 9 9 9 9 9 9 9 9 9 9 9 9 9
9 9 9 9 9 9 9 9 f f f f f f f f f f f f f f f 6 6 6 6 4 4 4 4 4 4 4 4 4 4 6 6 6 9 9 9 9 k j j j j j j j j j j k 4 4 2 2 2 2 2 2 2 2 2 2 2 2 2 2 2 2 2 2 2 2 2 2 2 2 2 2 2 2 2 2 2 2 2 2 2 2 2 4 4 4 4 4 4 4 4 4 4 4 4 4 4 4 b 4 a 4 9 9 9 9 9 9 9 9 9 9 9 9 9 9 9 9 9 9
9 9 9 9 9 9 9 9 f f f f f f f f f f 6 6 5 5 6 6 6 4 4 4 4 4 4 4 4 4 4 4 4 4 6 6 9 9 9 9 k k k k k k k k k k k k 4 4 4 a 4 4 b 4 4 4 4 4 4 4 4 a 4 4 4 4 4 4 a 4 4 4 4 4 4 4 4 4 4 4 4 4 4 2 2 4 4 4 b 4 4 4 4 b 4 4 4 4 4 4 4 4 4 4 9 9 9 9 9 9 9 9 9 9 9 9 9 9 9 9 9 9
9 9 9 9 9 9 9 9 f f f f f f f f f 6 6 6 5 5 6 4 4 4 4 4 4 4 4 4 4 4 4 4 4 4 6 6 9 9 9 9 9 9 9 9 9 4 4 4 4 4 4 4 b 4 4 4 4 4 4 4 a 4 4 b 4 4 4 4 a 4 4 b 4 4 4 4 4 4 4 4 4 a 4 4 4 a 4 4 4 2 2 4 a 4 4 4 4 a 4 4 4 a 4 4 4 4 a 4 4 9 9 9 9 9 9 9 9 9 9 9 9 9 9 9 9 9 9 9
9 9 9 9 9 9 9 9 f f f f f f f 6 6 6 6 4 4 4 4 4 4 4 4 4 4 4 4 4 4 4 4 4 4 4 6 6 6 9 9 9 9 9 9 9 9 4 4 a 4 9 9 9 9 9 9 9 9 9 9 9 4 9 9 9 9 9 9 9 9 9 9 9 9 9 9 4 4 4 4 b 4 4 4 4 4 4 4 4 4 2 2 4 4 4 a 4 4 4 4 b 4 4 4 4 a 4 4 4 9 9 9 9 9 9 9 9 9 9 9 9 9 9 9 9 9 9 9 9
9 9 9 9 9 9 9 9 f f f f f f 6 6 6 6 4 4 4 4 4 4 4 4 4 4 4 4 4 4 4 4 4 4 4 4 4 6 6 6 6 9 9 9 9 9 9 4 4 4 9 9 9 9 9 9 9 9 9 9 9 9 4 9 9 9 9 9 9 9 g g g g g g g 4 a 4 4 4 4 4 4 4 a 4 4 4 4 2 2 b 4 4 4 4 b 4 4 4 4 b 4 4 4 4 4 9 9 9 9 9 9 9 9 9 9 9 9 9 9 9 9 9 9 9 9 9
6 6 6 6 6 6 6 6 6 6 6 6 6 6 6 6 4 4 4 4 4 4 4 4 4 4 4 4 4 4 4 4 4 4 4 4 4 4 4 6 6 6 6 9 9 9 9 9 9 4 4 9 9 9 9 9 9 9 9 9 9 9 9 9 4 9 9 9 9 9 9 9 g 1 1 1 1 1 g 4 4 b 4 4 4 4 4 4 4 4 4 a 4 2 2 4 4 a 4 4 4 4 a 4 4 4 4 4 4 9 9 9 9 9 9 9 9 9 9 9 9 9 9 9 9 9 9 9 9 9 9 9
6 6 6 6 6 6 6 6 6 6 6 6 6 6 6 4 4 4 4 4 4 4 4 4 4 4 4 4 4 4 4 4 4 4 4 4 4 4 4 4 4 6 6 6 9 9 9 9 9 9 9 9 9 9 9 9 9 9 9 9 9 9 9 9 4 9 9 9 9 9 9 9 g 1 1 1 1 1 g 4 4 4 4 4 a 4 4 4 a 4 4 4 4 2 2 4 4 4 b 4 4 4 4 a 4 4 4 4 9 9 9 9 9 9 9 9 9 9 9 9 9 9 9 9 9 9 9 9 9 9 9 9
9 9 9 9 9 9 9 9 4 4 4 4 4 4 4 4 4 4 4 4 4 4 4 4 4 4 4 4 4 4 4 4 4 4 4 4 4 4 4 4 4 4 6 6 6 9 9 9 9 9 9 9 9 9 9 9 9 9 9 9 9 9 9 9 4 9 9 9 9 9 9 9 g 1 1 1 1 1 2 2 2 2 2 2 2 2 2 2 2 2 2 2 2 2 2 4 a 4 4 4 4 a 4 4 4 a 4 9 9 9 9 9 9 9 9 9 9 9 9 9 9 9 9 9 9 9 9 9 9 9 9 9
9 9 9 9 9 9 9 9 4 4 4 4 4 4 4 4 4 4 4 4 4 4 4 4 4 4 4 4 4 4 4 4 4 4 4 4 4 4 4 4 4 4 4 6 6 5 6 6 9 9 9 9 9 9 9 9 9 9 9 9 9 9 9 9 4 9 9 9 9 9 9 9 g 1 1 1 1 1 g 4 b 4 4 4 2 4 4 4 4 4 4 b 4 4 4 4 4 4 b 4 4 4 4 b 4 4 9 9 9 9 9 9 9 9 9 9 9 9 9 9 9 9 9 9 9 9 9 9 9 9 9 9
9 9 9 9 9 9 9 9 4 4 4 4 4 4 4 4 4 4 4 4 4 4 4 4 4 4 4 4 4 4 4 4 4 4 4 4 4 4 4 4 4 4 4 4 6 5 6 6 9 9 9 9 9 9 9 9 9 9 9 9 9 9 9 9 4 9 9 9 9 9 9 9 g g g g g g g 4 4 4 a 4 2 4 g g g g g g g g g g g g g 9 4 a 4 4 4 a 9 e e e e e e e e e e e e e e e e e 9 9 9 9 9 9 9 9
9 9 9 9 9 9 9 9 4 4 4 4 4 4 4 4 4 4 4 4 4 4 4 4 4 4 4 4 4 4 4 4 4 4 4 4 4 4 4 4 4 4 4 4 4 4 6 6 6 9 9 9 9 9 9 9 9 8 9 9 9 9 9 9 4 9 9 9 9 9 9 9 9 9 9 9 9 9 9 4 a 4 4 4 2 4 g 1 1 1 1 1 1 1 1 1 1 1 g 9 4 4 4 a 4 4 9 e 3 3 3 3 3 3 3 3 3 3 3 3 3 3 3 e 9 9 9 9 9 9 9 9
9 9 9 9 9 9 9 9 4 4 4 4 4 4 4 4 4 4 4 4 4 4 4 4 4 4 4 4 4 4 4 4 4 4 4 4 4 4 4 4 4 4 4 4 4 4 4 6 6 9 9 9 9 9 9 9 9 4 9 9 9 9 9 9 4 9 9 9 9 9 9 9 a b a b a b a 4 4 4 4 4 2 b g 1 1 1 1 1 1 1 1 1 1 1 g 9 a 4 4 4 4 b 9 e 3 3 3 3 3 3 3 3 3 3 3 3 3 3 3 e 9 9 9 9 9 9 9 9
9 9 9 9 9 9 9 9 4 4 4 4 4 4 4 4 4 4 4 4 4 4 4 4 4 4 4 4 4 4 4 4 4 4 4 4 4 4 4 4 4 4 4 4 4 4 4 6 6 9 9 9 9 9 9 9 9 4 9 9 9 9 9 9 4 9 9 9 9 9 9 9 b a b a b a b 4 b 4 a 4 2 4 g 1 1 1 1 1 1 1 1 1 1 1 g 9 4 4 a 4 4 4 9 e 3 3 3 3 3 3 3 3 3 3 3 3 3 3 3 e 9 9 9 9 9 9 9 9
9 9 9 9 9 9 9 9 4 4 4 4 4 4 4 4 4 4 4 4 4 4 4 4 4 4 4 4 4 4 4 4 4 4 4 4 4 4 4 4 4 4 4 4 4 4 4 4 6 6 9 9 9 9 9 9 9 4 9 9 9 9 9 9 4 9 9 9 9 9 9 9 a b a b a b a 2 2 2 2 2 2 4 g 1 1 1 1 1 1 1 1 1 1 1 g 9 4 4 4 b 4 4 9 e 3 3 3 3 3 3 3 3 3 3 3 3 3 3 3 e 9 9 9 9 9 9 9 9
9 9 9 9 9 9 9 9 4 4 4 4 4 4 4 4 4 4 4 4 4 4 4 4 4 4 4 4 4 4 4 4 4 4 4 4 4 4 4 4 4 4 4 4 4 4 4 4 6 6 6 9 9 9 9 9 9 4 9 9 9 9 9 9 4 9 9 9 9 9 9 9 b a b a b a b 4 4 4 4 4 2 4 g 1 1 1 1 1 1 1 1 1 1 1 g 9 4 a 4 4 4 a 9 e 3 3 3 3 3 3 3 3 3 3 3 3 3 3 3 e 9 9 9 9 9 9 9 9
9 9 9 9 9 9 9 9 4 4 4 4 4 4 4 4 4 4 4 4 4 4 4 4 4 4 4 4 4 4 4 4 4 4 4 4 4 4 4 4 4 4 4 4 4 4 4 4 4 6 6 9 9 9 9 9 9 4 4 4 4 4 4 4 4 9 9 9 9 9 9 9 9 9 9 9 9 9 9 4 a 4 4 4 2 4 g g g g 2 2 g g g g g g g 9 9 9 9 9 9 9 9 e 3 3 3 3 3 3 3 3 3 3 3 3 3 3 3 e 9 9 9 9 9 9 9 9
9 9 9 9 9 9 9 9 4 4 4 4 4 4 4 4 4 4 4 4 4 4 4 4 4 4 4 4 4 4 4 4 4 4 4 4 4 4 4 4 4 4 4 4 4 4 4 4 4 5 5 9 9 9 9 9 9 9 9 9 9 9 9 9 9 9 9 9 9 9 9 9 g g g g g g g 4 4 4 a 4 2 4 a 4 4 a 2 2 4 4 4 4 b 4 4 4 4 4 b 4 4 4 4 e 3 3 3 3 3 3 3 3 3 3 3 3 3 3 3 e 9 9 9 9 9 9 9 9
9 9 9 9 9 9 9 9 4 4 4 4 4 4 4 4 4 4 4 4 4 4 4 4 4 4 4 4 4 4 4 4 4 4 4 4 4 4 4 4 4 4 4 4 4 4 4 4 4 6 6 6 9 9 9 9 9 9 9 9 9 9 9 9 9 9 9 9 9 9 9 9 g 1 1 1 1 1 g 4 b 4 4 4 2 2 2 2 2 2 2 2 2 2 2 2 2 2 2 2 2 2 2 2 2 2 2 e 3 3 3 3 3 3 3 3 3 3 3 3 3 3 3 e 9 9 9 9 9 9 9 9
9 9 9 9 9 9 9 9 4 4 4 4 4 4 4 4 4 4 4 4 4 4 4 4 4 4 4 4 4 4 4 4 4 4 4 4 4 4 4 4 4 4 4 4 4 4 4 4 4 4 6 6 6 9 9 9 9 9 9 9 9 9 9 9 9 9 9 9 9 9 9 9 g 1 1 1 1 1 2 2 2 2 2 2 2 2 a a a a a a a a a a a a a a a 4 4 4 a 4 4 e 3 3 3 3 3 3 3 3 3 3 3 3 3 3 3 e 9 9 9 9 9 9 9 9
9 9 9 9 9 9 9 9 4 4 4 4 4 4 4 4 4 4 4 4 4 4 4 4 4 4 4 4 4 4 4 4 4 4 4 4 4 4 4 4 4 4 4 4 4 4 4 4 4 4 4 6 6 9 9 9 9 9 9 9 9 9 9 9 9 9 9 9 9 9 9 9 g 1 1 1 1 1 g 4 4 4 4 4 2 2 a h h h h h h h h h h h h h a 4 a 4 4 4 a e 3 3 3 3 3 3 3 3 3 3 3 3 3 3 3 e 9 9 9 9 9 9 9 9
9 9 9 9 9 9 9 9 4 4 4 4 4 4 4 4 4 4 4 4 4 4 4 4 4 4 4 4 4 4 4 4 4 4 4 4 4 4 4 4 4 4 4 4 4 4 4 4 4 4 4 4 6 6 9 9 9 9 9 9 9 9 9 9 9 9 9 9 9 9 9 9 g g g g g g g 4 a 4 4 4 2 2 a h 0 0 0 0 0 0 0 0 0 0 0 h a 4 4 4 b 4 4 e 3 3 3 3 3 3 3 3 3 3 3 3 3 3 3 e 9 9 9 9 9 9 9 9
9 9 9 9 9 9 9 9 4 4 4 4 4 4 4 4 4 4 4 4 4 4 4 4 4 4 4 4 4 4 4 4 4 4 4 4 4 4 4 4 4 4 4 4 4 4 4 4 4 4 4 4 6 6 9 9 9 9 9 9 9 9 9 9 9 9 9 9 9 9 9 9 9 9 9 9 9 9 9 4 4 4 a 4 2 2 a h 0 0 0 0 0 0 0 0 0 0 0 h a b 4 4 4 4 b e 3 3 3 3 3 3 3 3 3 3 3 3 3 3 3 e 9 9 9 9 9 9 9 9
9 9 9 9 9 9 9 9 4 4 4 4 4 4 4 4 4 4 4 4 4 4 4 4 4 4 4 4 4 4 4 4 4 4 4 4 4 4 4 4 4 4 4 4 4 4 4 4 4 4 4 4 6 6 6 6 9 9 9 9 9 9 9 9 9 9 9 9 9 9 9 9 g g g g g g g 4 4 4 4 4 2 2 a h 0 0 0 0 0 0 0 0 0 0 0 h a 4 4 a 4 4 4 e 3 3 3 3 3 3 3 3 3 3 3 3 3 3 3 e 9 9 9 9 9 9 9 9
9 9 9 9 9 9 9 9 4 4 4 4 4 4 4 4 4 4 4 4 4 4 4 4 4 4 4 4 4 4 4 4 4 4 4 4 4 4 4 4 4 4 4 4 4 4 4 4 4 4 4 4 4 6 6 6 9 9 9 9 9 9 9 9 9 9 9 9 9 9 9 9 g 1 1 1 1 1 g 4 a 4 4 4 2 2 2 2 0 0 0 0 0 0 0 0 0 0 0 h a 4 4 4 b 4 4 e 3 3 3 3 3 3 3 3 3 3 3 3 3 3 3 e 9 9 9 9 9 9 9 9
9 9 9 9 9 9 9 9 4 4 4 4 4 4 4 4 4 4 4 4 4 4 4 4 4 4 4 4 4 4 4 4 4 4 4 4 4 4 4 4 4 4 4 4 4 4 4 4 4 4 4 4 4 4 6 6 9 9 9 9 9 9 9 9 9 9 9 9 9 9 9 9 g 1 1 1 1 1 g 4 4 4 b 4 2 2 a h 0 0 0 0 0 0 0 0 0 0 0 h a 4 a 4 4 4 a e e e e e e e e e e e e e e e e e 9 9 9 9 9 9 9 9
9 9 9 9 9 9 9 9 4 4 4 4 4 4 4 4 4 4 4 4 4 4 4 4 4 4 4 4 4 4 4 4 4 4 4 4 4 4 4 4 4 4 4 4 4 4 4 4 4 4 4 4 4 4 6 6 9 9 9 9 9 9 9 9 9 9 9 9 9 9 9 9 g 1 1 1 1 1 2 2 2 2 2 2 2 2 a h 0 0 0 0 0 0 0 0 0 0 0 h a 4 4 4 b 4 4 4 4 4 4 a 4 4 4 4 4 4 4 4 4 a 4 4 9 9 9 9 9 9 9 9
9 9 9 9 9 9 9 9 4 4 4 4 4 4 4 4 4 4 4 4 4 4 4 4 4 4 4 4 4 4 4 4 4 4 4 4 4 4 4 4 4 4 4 4 4 4 4 4 4 4 4 4 4 4 4 6 6 9 9 9 9 9 9 9 9 9 9 9 9 9 9 9 g 1 1 1 1 1 g 4 b 4 4 a 4 4 a h h h h h h h h h 0 0 0 h a a 4 4 4 b 4 4 4 4 4 4 b 4 4 4 b 4 4 a 4 4 4 a 9 9 9 9 9 9 9 9
9 9 9 9 9 9 9 9 4 4 4 4 4 4 4 4 4 4 4 4 4 4 4 4 4 4 4 4 4 4 4 4 4 4 4 4 4 4 4 4 4 4 4 4 4 4 4 4 4 4 4 4 4 4 4 6 6 9 9 9 9 9 9 9 9 9 9 9 9 9 9 9 g 1 1 1 1 1 g 4 4 4 4 4 4 b a a a a a a a a a h 0 0 0 h a 4 4 b 4 4 4 a 4 4 a 4 4 4 a 4 4 4 4 4 4 b 4 4 9 9 9 9 9 9 9 9
9 9 9 9 9 9 9 9 4 4 4 4 4 4 4 4 4 4 4 4 4 4 4 4 4 4 4 4 4 4 4 4 4 4 4 4 4 4 4 4 4 4 4 4 4 4 4 4 4 4 4 4 4 4 4 6 6 9 9 9 9 9 9 9 9 9 9 9 9 9 9 9 g 1 1 1 1 1 g 4 4 a 4 4 4 4 4 b 4 4 4 4 4 4 a h 0 0 0 h a 4 4 4 4 a 4 4 b 4 4 4 b 4 4 a 4 4 b 4 4 4 4 b 9 9 9 9 9 9 9 9
9 9 9 9 9 9 9 9 4 4 4 4 4 4 4 4 4 4 4 4 4 4 4 4 4 4 4 4 4 4 0 1 2 3 4 5 6 7 8 9 a b c d e f g h i j k 4 4 4 4 6 6 9 9 9 9 9 9 9 9 9 9 9 9 9 9 9 g g g g g g g 4 4 4 b 4 4 a 4 4 4 a 4 4 b 4 a h h h h h a 4 a 4 4 4 4 b 4 a 4 4 4 4 b 4 4 a 4 4 4 4 b 4 9 9 9 9 9 9 9 9
9 9 9 9 9 9 9 9 9 9 9 9 9 9 9 9 9 9 9 9 9 9 9 9 9 9 9 9 9 9 9 9 9 9 9 9 9 9 9 9 9 9 9 9 9 9 9 9 9 9 9 9 9 9 9 6 6 9 9 9 9 9 9 9 9 9 9 9 9 9 9 9 9 9 9 9 9 9 9 9 9 9 9 9 9 9 9 9 9 9 9 9 9 9 9 9 9 9 9 9 9 9 9 9 9 9 9 9 9 9 9 9 9 9 9 9 9 9 9 9 9 9 9 9 9 9 9 9 9 9 9 9
9 9 9 9 9 9 9 9 9 9 9 9 9 9 9 9 9 9 9 9 9 9 9 9 9 9 9 9 9 9 9 9 9 9 9 9 9 9 9 9 9 9 9 9 9 9 9 9 9 9 9 9 9 9 9 6 6 9 9 9 9 9 9 9 9 9 9 9 9 9 9 9 9 9 9 9 9 9 9 9 9 9 9 9 9 9 9 9 9 9 9 9 9 9 9 9 9 9 9 9 9 9 9 9 9 9 9 9 9 9 9 9 9 9 9 9 9 9 9 9 9 9 9 9 9 9 9 9 9 9 9 9
9 9 9 9 9 9 9 9 9 9 9 9 9 9 9 9 9 9 9 9 9 9 9 9 9 9 9 9 9 9 9 9 9 9 9 9 9 9 9 9 9 9 9 9 9 9 9 9 9 9 9 9 9 9 9 6 6 9 9 9 9 9 9 9 9 9 9 9 9 9 9 9 9 9 9 9 9 9 9 9 9 9 9 9 9 9 9 9 9 9 9 9 9 9 9 9 9 9 9 9 9 9 9 9 9 9 9 9 9 9 9 9 9 9 9 9 9 9 9 9 9 9 9 9 9 9 9 9 9 9 9 9
9 9 9 9 9 9 9 9 9 9 9 9 9 9 9 9 9 9 9 9 9 9 9 9 9 9 9 9 9 9 9 9 9 9 9 9 9 9 9 9 9 9 9 9 9 9 9 9 9 9 9 9 9 9 9 6 6 9 9 9 9 9 9 9 9 9 9 9 9 9 9 9 9 9 9 9 9 9 9 9 9 9 9 9 9 9 9 9 9 9 9 9 9 9 9 9 9 9 9 9 9 9 9 9 9 9 9 9 9 9 9 9 9 9 9 9 9 9 9 9 9 9 9 9 9 9 9 9 9 9 9 9
9 9 9 9 9 9 9 9 9 9 9 9 9 9 9 9 9 9 9 9 9 9 9 9 9 9 9 9 9 9 9 9 9 9 9 9 9 9 9 9 9 9 9 9 9 9 9 9 9 9 9 9 9 9 9 6 6 9 9 9 9 9 9 9 9 9 9 9 9 9 9 9 9 9 9 9 9 9 9 9 9 9 9 9 9 9 9 9 9 9 9 9 9 9 9 9 9 9 9 9 9 9 9 9 9 9 9 9 9 9 9 9 9 9 9 9 9 9 9 9 9 9 9 9 9 9 9 9 9 9 9 9
9 9 9 9 9 9 9 9 9 9 9 9 9 9 9 9 9 9 9 9 9 9 9 9 9 9 9 9 9 9 9 9 9 9 9 9 9 9 9 9 9 9 9 9 9 9 9 9 9 9 9 9 9 9 9 6 6 9 9 9 9 9 9 9 9 9 9 9 9 9 9 9 9 9 9 9 9 9 9 9 9 9 9 9 9 9 9 9 9 9 9 9 9 9 9 9 9 9 9 9 9 9 9 9 9 9 9 9 9 9 9 9 9 9 9 9 9 9 9 9 9 9 9 9 9 9 9 9 9 9 9 9
9 9 9 9 9 9 9 9 9 9 9 9 9 9 9 9 9 9 9 9 9 9 9 9 9 9 9 9 9 9 9 9 9 9 9 9 9 9 9 9 9 9 9 9 9 9 9 9 9 9 9 9 9 9 9 6 6 9 9 9 9 9 9 9 9 9 9 9 9 9 9 9 9 9 9 9 9 9 9 9 9 9 9 9 9 9 9 9 9 9 9 9 9 9 9 9 9 9 9 9 9 9 9 9 9 9 9 9 9 9 9 9 9 9 9 9 9 9 9 9 9 9 9 9 9 9 9 9 9 9 9 9
9 9 9 9 9 9 9 9 9 9 9 9 9 9 9 9 9 9 9 9 9 9 9 9 9 9 9 9 9 9 9 9 9 9 9 9 9 9 9 9 9 9 9 9 9 9 9 9 9 9 9 9 9 9 9 6 6 9 9 9 9 9 9 9 9 9 9 9 9 9 9 9 9 9 9 9 9 9 9 9 9 9 9 9 9 9 9 9 9 9 9 9 9 9 9 9 9 9 9 9 9 9 9 9 9 9 9 9 9 9 9 9 9 9 9 9 9 9 9 9 9 9 9 9 9 9 9 9 9 9 9 9